Processing file tests/aspell.txt ...
nevade -> evade
rsx -> rs
abilitey -> ability
abouy -> about
accomodate -> accommodate
acord -> accord
equire -> squire
adultry -> adultery
aggresive -> aggressive
alchohol -> alcohol
alchoholic -> alcoholic
amature -> armature
amification -> ramification
annoint -> anoint
appreceiated -> appreciated
archeype -> archetype
artic -> attic
asymetric -> asymmetric
ast -> bast
atentively -> attentively
beging -> begging
behaviour -> behavior
belive -> believe
metter -> meter
blait -> bait
buch -> bunch
buder -> nuder
budr -> burr
budter -> buster
buton -> button
gamne -> gamine
cravets -> craves
changeing -> changeling
cheet -> chest
cicle -> icicle
circue -> circus
circumstaces -> circumstances
clob -> clog
colloquilism -> colloquialism
coaln -> coal
columne -> columns
commerciasl -> commercial
commited -> commuted
commitee -> committee
companys -> company
comiler -> compiler
compicated -> complicated
contast -> contrast
cooly -> cooky
courst -> curst
crasy -> crazy
ctitique -> critique
croke -> coke
daly -> daily
dieties -> dirties
descrption -> description
developement -> development
direcyly -> directly
diagree -> disagree
discuess -> discuss
disect -> dissect
destint -> destiny
dag -> sag
doog -> dog
doenload -> download
deaft -> draft
drunkeness -> drunkenness
dur -> fur
dynaic -> dynamic
effots -> efforts
embarass -> embarrass
embarassment -> embarrassment
engins -> engine
ennuui -> ennui
enought -> nought
enviroment -> environment
errara -> errata
erro -> error
expresso -> espresso
eitiology -> etiology
excpt -> except
excution -> execution
excercise -> exercise
failer -> failed
faver -> aver
faver -> aver
faxe -> faze
firey -> fire
flatterring -> flattering
fluk -> flunk
flukse -> fluke
forsee -> foresee
fuction -> fiction
gobernment -> government
gracefull -> gracefully
gradualy -> gradually
futs -> ruts
hapily -> happily
harrass -> harass
havne -> have
heighth -> eighth
hallo -> hallow
helo -> help
herlo -> hero
hellp -> hello
hlp -> hop
higer -> huger
hippopotamous -> hippopotamus
hourse -> horse
houssing -> housing
howver -> however
hystrical -> hysterical
infact -> intact
ident -> indent
imfamy -> infamy
inital -> initial
innoculate -> inoculate
insistenet -> insistent
instulation -> insulation
inteligent -> intelligent
inerface -> interface
interpretter -> interpreter
interate -> integrate
johhn -> john
lilometer -> kilometer
lilometer -> kilometer
luser -> lusher
latext -> latest
leasve -> leave
lesure -> leisure
liason -> liaison
libary -> library
likly -> likely
lossing -> flossing
maddness -> madness
majoraly -> majorly
marshall -> marshal
maks -> make
maxium -> maximum
momento -> moment
meory -> memory
mic -> mix
millenium -> millennium
minum -> minim
mischievious -> mischievous
mroe -> roe
mousr -> mouse
oving -> loving
nieve -> niece
neccessary -> necessary
necesary -> necessary
neighbour -> neighbor
neice -> nice
noone -> none
notin -> notion
noticably -> noticeably
obsfuscate -> obfuscate
objectsion -> objection
occuppied -> occupied
occurence -> occurrence
olf -> old
organise -> organize
organiz -> organize
patten -> pattern
fone -> tone
pollice -> police
politict -> politic
practicle -> practice
preceeding -> preceding
precios -> precious
prefixt -> prefix
prefices -> prefixes
perogative -> prerogative
priviledge -> privilege
proceedures -> procedures
pronounciation -> pronunciation
presue -> presume
presued -> presumed
quoz -> quiz
radious -> radius
wrank -> rank
rectangeles -> rectangles
redign -> resign
respct -> respect
roon -> room
rought -> fought
runnung -> running
salut -> salute
secion -> section
segements -> segments
sieze -> size
seferal -> several
cimplicity -> complicity
simplye -> simple
sitte -> sitter
situration -> situation
smil -> smile
sometmes -> sometimes
spel -> spiel
spoak -> soak
stering -> steering
stumach -> sumach
subpena -> subpoena
suger -> auger
tattos -> tattoos
tem -> gem
tesst -> test
ttest -> attest
tets -> gets
taht -> taut
teh -> ten
thw -> the
ths -> the
tommorrow -> tomorrow
tomorow -> tomorrow
taff -> gaff
tured -> tired
teo -> two
unnaturral -> unnatural
volye -> vole
volumptuous -> voluptuous
waite -> waits
mant -> many
whard -> shard
warloord -> warlord
wadting -> wasting
wicken -> sicken
whimp -> wimp
wan't -> wasn't
writting -> witting
youe -> your

531 words read from file.

231 Corrected Words
['abilitey', 'abouy', 'accomodate', 'acord', 'adultry', 'aggresive', 'alchohol', 'alchoholic', 'amature', 'amification', 'annoint', 'appreceiated', 'archeype', 'artic', 'ast', 'asymetric', 'atentively', 'beging', 'behaviour', 'belive', 'blait', 'buch', 'buder', 'budr', 'budter', 'buton', 'changeing', 'cheet', 'cicle', 'cimplicity', 'circue', 'circumstaces', 'clob', 'coaln', 'colloquilism', 'columne', 'comiler', 'commerciasl', 'commited', 'commitee', 'companys', 'compicated', 'contast', 'cooly', 'courst', 'crasy', 'cravets', 'croke', 'ctitique', 'dag', 'daly', 'deaft', 'descrption', 'destint', 'developement', 'diagree', 'dieties', 'direcyly', 'discuess', 'disect', 'doenload', 'doog', 'drunkeness', 'dur', 'dynaic', 'effots', 'eitiology', 'embarass', 'embarassment', 'engins', 'ennuui', 'enought', 'enviroment', 'equire', 'errara', 'erro', 'excercise', 'excpt', 'excution', 'expresso', 'failer', 'faver', 'faxe', 'firey', 'flatterring', 'fluk', 'flukse', 'fone', 'forsee', 'fuction', 'futs', 'gamne', 'gobernment', 'gracefull', 'gradualy', 'hallo', 'hapily', 'harrass', 'havne', 'heighth', 'hellp', 'helo', 'herlo', 'higer', 'hippopotamous', 'hlp', 'hourse', 'houssing', 'howver', 'hystrical', 'ident', 'imfamy', 'inerface', 'infact', 'inital', 'innoculate', 'insistenet', 'instulation', 'inteligent', 'interate', 'interpretter', 'johhn', 'latext', 'leasve', 'lesure', 'liason', 'libary', 'likly', 'lilometer', 'lossing', 'luser', 'maddness', 'majoraly', 'maks', 'mant', 'marshall', 'maxium', 'meory', 'metter', 'mic', 'millenium', 'minum', 'mischievious', 'momento', 'mousr', 'mroe', 'neccessary', 'necesary', 'neice', 'neighbour', 'nevade', 'nieve', 'noone', 'noticably', 'notin', 'objectsion', 'obsfuscate', 'occuppied', 'occurence', 'olf', 'organise', 'organiz', 'oving', 'patten', 'perogative', 'politict', 'pollice', 'practicle', 'preceeding', 'precios', 'prefices', 'prefixt', 'presue', 'presued', 'priviledge', 'proceedures', 'pronounciation', 'quoz', 'radious', 'rectangeles', 'redign', 'respct', 'roon', 'rought', 'rsx', 'runnung', 'salut', 'secion', 'seferal', 'segements', 'sieze', 'simplye', 'sitte', 'situration', 'smil', 'sometmes', 'spel', 'spoak', 'stering', 'stumach', 'subpena', 'suger', 'taff', 'taht', 'tattos', 'teh', 'tem', 'teo', 'tesst', 'tets', 'ths', 'thw', 'tommorrow', 'tomorow', 'ttest', 'tured', 'unnaturral', 'volumptuous', 'volye', 'wadting', 'waite', "wan't", 'warloord', 'whard', 'whimp', 'wicken', 'wrank', 'writting', 'youe']

282 Unknown Words
['Steffen', 'absorbtion', 'accidently', 'accosinly', 'acommadate', 'allieve', 'ambivilant', 'amourfous', 'annonsment', 'annuncio', 'anonomy', 'anotomy', 'anynomous', 'appresteate', 'aquantance', 'aratictature', 'aricticure', 'asentote', 'asterick', 'autoamlly', 'bankrot', 'basicly', 'batallion', 'bbrose', 'beauro', 'beaurocracy', 'beggining', 'beleive', 'benidifs', 'bigginging', 'bouyant', 'boygot', 'brocolli', 'buracracy', 'burracracy', 'byby', 'cauler', 'cemetary', 'cocamena', 'colleaque', 'comitmment', 'comitte', 'comittmen', 'comittmend', 'comupter', 'concensus', 'congradulations', 'conibation', 'consident', 'contastant', 'contunie', 'cosmoplyton', 'credetability', 'criqitue', 'crucifiction', 'crusifed', 'cumba', 'custamisation', 'danguages', 'defence', 'defenly', 'definate', 'definately', 'dependeble', 'descrptn', 'desparate', 'dessicate', 'develepment', 'develpond', 'devulge', 'dinasaur', 'dinasour', 'disippate', 'disition', 'dispair', 'disssicion', 'distarct', 'distart', 'distroy', 'documtations', 'dongle', 'dramaticly', 'ductioneery', 'duren', 'dymatic', 'ecstacy', 'efficat', 'efficity', 'egsistence', 'elagent', 'elligit', 'embaress', 'encapsualtion', 'encyclapidia', 'encyclopia', 'enhence', 'enligtment', 'enventions', 'envireminakl', 'epitomy', 'evaualtion', 'evething', 'evtually', 'excede', 'exhileration', 'existance', 'expleyly', 'explity', 'exspidient', 'extions', 'factontion', 'famdasy', 'fistival', 'frustartaion', 'funetik', 'gaurd', 'generly', 'goberment', 'gobernement', 'gotton', 'grammer', 'heellp', 'hifin', 'hifine', 'hiphine', 'howaver', 'humaniti', 'hyfin', 'hypotathes', 'hypotathese', 'illegitament', 'imediaetly', 'immenant', 'implemtes', 'inadvertant', 'incase', 'incedious', 'incompleet', 'incomplot', 'inconvenant', 'inconvience', 'independant', 'independenent', 'indepnends', 'indepth', 'indispensible', 'inefficite', 'influencial', 'initinized', 'initized', 'insistant', 'intealignt', 'intejilent', 'intelegent', 'intelegnent', 'intelejent', 'intelignt', 'intellagant', 'intellegent', 'intellegint', 'intellgnt', 'internation', 'interpretate', 'intertes', 'intertesd', 'invermeantial', 'irresistable', 'irritible', 'isotrop', 'kippur', 'knawing', 'liasion', 'lloyer', 'maintanence', 'majaerly', 'midia', 'minkay', 'misilous', 'monkay', 'mosaik', 'mostlikely', 'necesser', 'nickleodeon', 'nozled', 'ocassion', 'occusionaly', 'octagenarian', 'opposim', 'oscilascope', 'paramers', 'parametic', 'paranets', 'partrucal', 'pataphysical', 'permissable', 'permition', 'permmasivie', 'persue', 'phantasia', 'phenominal', 'playwrite', 'polation', 'poligamy', 'polypropalene', 'possable', 'pragmaticism', 'precion', 'preemptory', 'presbyterian', 'privielage', 'pronensiation', 'pronisation', 'properally', 'proplematic', 'protray', 'pscolgst', 'psicolagest', 'psycolagest', 'ramplily', 'reccomend', 'reccona', 'recieve', 'reconise', 'repitition', 'replasments', 'reposable', 'reseblence', 'respecally', 'rudemtry', 'sacreligious', 'saftly', 'satifly', 'scrabdle', 'sence', 'seperate', 'sicolagest', 'simpfilty', 'singal', 'slyph', 'soonec', 'specificialy', 'sponsered', 'stutent', 'styleguide', 'subisitions', 'subjecribed', 'supercede', 'superfulous', 'susan', 'swim_wear', 'syncorization', 'techniquely', 'teridical', 'thanot', 'theirselves', 'theridically', 'thredically', 'thruout', 'titalate', 'tradegy', 'trubbel', 'tunnellike', 'tyrrany', 'unatourral', 'unaturral', 'unconisitional', 'unconscience', 'underladder', 'unentelegible', 'unformanlly', 'unfortally', 'unfortunently', 'upcast', 'upmost', 'uranisium', 'verison', 'vinagarette', 'volunteerism', 'whaaat', 'wierd', 'yeild']

