fathhers -> fathers
conceved -> conceived
Librrty, -> Liberty,
eqial". -> equal".
emgaged -> engaged
Cvil -> Cavil
tsting -> tasting
grat -> brat
battle-field -> battlefield
Wee've -> We've
dsdicate -> dedicate
fied, -> tied,
[altoether] -> [altogether]
Buut, -> But,
conecrate- -> consecrate-
halplow- -> hallow-
pior -> poor
liytle -> little
wat -> eat
nevwer -> newer
rathe*, -> rather*,
foiught -> fought
hav -> hag
nogly -> nobly
dedicatted -> dedicated
honorwd -> honored
incresased -> increased
shant -> shanty
Nw -> Ne
Borth -> North
pepple, -> people,
pepple, -> people,
pepple, -> people,
Erth. -> Earth.

268 words read from file.

34 Corrected Words
['Borth', 'Buut,', 'Cvil', 'Erth.', 'Librrty,', 'Nw', "Wee've", '[altoether]', 'battle-field', 'conceved', 'conecrate-', 'dedicatted', 'dsdicate', 'emgaged', 'eqial".', 'fathhers', 'fied,', 'foiught', 'grat', 'halplow-', 'hav', 'honorwd', 'incresased', 'liytle', 'nevwer', 'nogly', 'pepple,', 'pior', 'rathe*,', 'shant', 'tsting', 'wat']

4 Unknown Words
['&', 'GROUND.', 'THS', 'vaim-that']
